########################################
#                                      #
#                                      #
#                                      #
#                                      #
#                                      #
#                                      #
#             ##                       #
#             <#                       #
#             <#                       #
#     P       <#       #               #
#             <#       #         ##    #
#             <#       #               #
#     ##########       #               #
#                      #               #
#                      #               #
#                      ########        #
##                    e #vvv#          #
#>                                     #
#>                               ###   #
#>                               ###   #
##########^^^^^^########################
########################################
